-------------------------
-----------------#-------
----------------#--------
----#--#----#-#----------
------#------------------
--#----------------#-----
-------------------------
-----#-#---#---#---------
-------------#----#------
-#-------------------#---
------#------#----#------
-------------------------
---------#------##-------
---#-------#--#--#-------
--------#-----#------#---
------------------#------
-----------#----#--#-----
--------------#----------
----------------##-------
#-#-#--#-----------------
-------------------------
----#----#---#-----------
--#------#-----#-----#---
---------#---------------
---------#---------------
