---#------
----#-----
#-#-#--#--
----------
----#----#
--#------#
---------#
---------#