---#------
----#-----
#-#-#--#--
----------
----#----#
--#------#
---------#
---------#
L,0,0
L,0,9
L,7,3
R,5,2
L,2,3
R,7,9
R,6,9
